WWWWWWWWWWWWWWW
W     BBB BBBBW
W W W W W W W W
W         B B W
WBW W W W WBW W
W P    R   B  W
W W W W W W W W
WB       B    W
WBW W W WBW W W
W    YBB   B BW
W WBW W W W W W
W            GW
WWWWWWWWWWWWWWW