WWWWWWWWWWWWWWW
W     BBB BBBBW
W W W W W W W W
W  R R    B B W
WBW   W W WBW W
W P G  R   B  W
W W W W W W W W
WB       B    W
WBW W W WBW W W
WR R YBB   B BW
W WBW W W W W W
W  Y YY       W
WWWWWWWWWWWWWWW