WWWWWWWWWWWWWWW
W     BBB BBBBW
W W W W W W W W
W      P  B B W
WBW W W W WBW W
W      R   B  W
W W W W W W W W
WB   B   B    W
WBW W W WBW W W
W    YBB   B BW
W WBW W W W W W
W        B   GW
WWWWWWWWWWWWWWW